,;,;,;,;,;,;,;,;,;,;,;,;,;,;,;,;,;,;,;,;,;,;,;,;,
#;.;.;.;.;.;.;.;.;.;.;.;.;.;.;.;.;.;.;.;.;.;.;.;#
#;.;.;.;.;.;.;.;.;.;.;.;.;.;.;.;.;.;.;.;.;.;.;.;#
#;.;.;.;.;.;.;.;.;.;.;.;.;.;.;.;.;.;.;.;.;.;.;.;#
#;.;.;.;.;.;.;.;.;.;.;.;.;.;.;.;.;.;.;.;.;.;.;.;#
#;.;.;.;.;.;.;.;.;.;.;.;.;.;.;.;.;.;#;.;.;.;.;.;#
#;.;.;.;.;.;.;.;.;.;.;.;.;.;.;.;.;.;#;#;.;.;.;.;#
#;.;.;.;.;.;.;.;.;.;.;.;.;.;.;.;.;.;#;#;.;.;.;.;#
#;.;.;.;.;.;.;.;.;.;.;.;.;.;.;.;.;.;.;.;.;.;.;.;#
#;.;.;.;.;.;.;.;.;.;.;.;.;.;.;.;.;.;.;.;.;.;.;.;#
#;.;.;^;.;.;.;.;.;.;.;.;.;.;.;.;.;.;.;.;.;.;.;.;#
#;.;.;|;.;#;#;#;.;.;.;.;.;.;.;.;.;.;.;.;.;.;.;.;#
#;.;.;%;.;#;.;.;.;.;.;.;.;.;.;.;.;.;.;.;.;.;.;.;#
#;.;.;#;#;#;#;.;.;.;.;.;.;.;.;.;.;.;.;.;.;.;.;.;#
#;.;.;.;#;#;#;.;.;.;.;.;.;.;.;.;.;.;.;.;.;.;.;.;#
#;.;.;^;.;.;.;.;.;.;.;.;.;.;.;.;.;.;.;.;^;.;.;.;#
#;^;^;|;.;.;.;.;.;.;.;.;.;.;.;.;.;.;.;^;|;.;.;.;#
#;#;%;%;.;.;.;.;.;.;.;.;.;.;.;^;^;.;.;%;%;^;.;#;#
#;#;#;#;#;#;#;#;#;#;#;#;#;#;#;#;#;#;#;#;#;#;#;#;#