,;,;,;,;,;,;,;,;,;,;,;,;,;,;,;,;,;,;,;,;,;,;,;,;,
#;.;.;.;.;.;.;.;.;.;.;.;.;.;.;.;.;.;.;.;.;.;.;.;#
#;.;.;.;.;.;.;.;.;.;.;.;.;.;.;.;.;.;.;.;.;.;.;.;#
#;.;.;.;.;.;.;.;.;.;.;.;.;.;.;.;.;.;.;.;.;.;.;.;#
#;.;.;.;.;.;.;.;.;.;.;.;.;.;.;.;.;.;.;.;.;.;.;.;#
#;.;.;.;.;.;.;.;.;.;.;.;.;.;.;.;.;.;#;.;.;.;.;.;#
#;.;.;.;.;.;.;.;.;.;.;.;.;.;.;.;.;.;#;#;.;.;.;.;#
#;.;.;.;.;.;.;.;.;.;.;.;.;.;.;.;.;.;#;#;.;.;.;.;#
#;.;.;.;.;.;.;.;.;.;.;.;.;.;.;.;.;.;.;.;.;.;.;.;#
#;.;.;.;.;.;.;.;.;.;.;.;.;.;.;.;.;.;.;.;.;.;.;.;#
#;.;.;.;.;.;.;.;.;.;.;.;.;.;.;.;.;.;.;.;.;.;.;.;#
#;.;.;|;.;#;#;#;.;.;.;.;.;.;.;.;.;.;.;.;.;.;.;.;#
#;.;.;|;.;#;.;.;.;.;.;.;.;.;.;.;.;.;.;.;.;.;.;.;#
#;.;.;#;#;#;#;.;.;.;.;.;.;.;.;.;.;.;.;.;.;.;.;.;#
#;.;.;.;#;#;#;.;.;.;.;.;.;.;.;.;.;.;.;.;.;.;.;.;#
#;.;.;|;.;.;.;.;.;.;.;.;.;.;.;.;.;.;.;.;.;.;.;.;#
#;|;|;|;.;.;.;.;.;.;.;.;.;.;.;.;.;.;.;|;|;.;.;.;#
#;#;|;|;.;.;.;.;.;.;.;.;.;.;.;|;|;.;.;|;|;|;.;#;#
#;#;#;#;#;#;#;#;#;#;#;#;#;#;#;#;#;#;#;#;#;#;#;#;#